##################################################
#..OO#...OO.#..OO......O...O.##...O.O...#..O.....#
#.#.O..O.##.O#.....O#.O.O.O..O.#............OOO.##
#OO....#..O...##OO.#O#OO...O..#...........OO.O..##
#.#.#..O.O...OO.OO#....O.OOO.O#..#......O......#O#
#.O#O..O..O#O..O...OOO#OOO...O...O.#OOO..OOO.....#
##.#..O....#.......##......OO.O.....O#..OO..O....#
#....OO...OO....#O....O..#..O........#.O....O.O..#
#O..O.#...O#......O#OOOO....#.............OO.#.#.#
#....#.##.#...O#...#...O..O#O..O.O.......O.OO.##.#
#...O..OO.#..O.O#.#.....O..O..O..O....OOO..OO#...#
#O..O...O...#.O.O.OO.O.O.O#..O..#.#OO.O.....O....#
#.O.#....O......O.OO#..O....O..O...O#..#O....O#..#
#O.......OO.....O...OO........OO.#.#O.OO.O.....O.#
#....OO....#O.O......O............O.OO.O....##.#.#
#...O...O.#OO...O.....OOO...#.O.O.O..O.....O...O.#
#....O.O.....O.O........#.O....O..#.O..OO.OOO...O#
#O.O..O.....OO.O.O....O.....OO..O.....#.......O.##
#..#.#........#.#......O.....O..O.......O....O...#
#........O#..#....#...O...O..O..O......##OOO.....#
#O....O..O......#..#..#.OOO..O....O....#.....#O..#
#O....O...#.O....O...O.O.#O.....O.............#O.#
#..O..O...O.OO..O....OO........OO#..#..OO.O.OO.O.#
##.OO.O.O.....O.O.O......O.O.O...#O.....O..O.....#
#....O..#O..#O..O.O.OO..@#OO#................OOO.#
#....O...#....O.#..#.O...#.....O..#.....#...O#O..#
#.#O....O..O.......O...O#..O.....O..#.#....OOO...#
#...O....O..O.....O...OOO.O...OO##..##OO#...O...O#
#....OO...O...#.O...O.OO.#...O.OOO....#........O.#
#.O#...OO.OO.....O.......O.....#...#.O...........#
#.OO.O..OO...##.O......#.OO...O#O.....OO...O...#O#
#O..O..OO....#....O...O#.OO....##...O.#...O..O..O#
#O...#.OOOO...##O..............O.O....O#....O..OO#
#.....O.O...O...O..#O..#.O...O..O.#.....O...O.OO.#
#...#O...O.O...O.O#OO.#.O.........O..O...O...O...#
#OOO.OOO.O...O..OOO........O.OO.....O..OOOO......#
#.#.##.O#...O.....OO#..O...OOO..OO.#.O..#..OO....#
#.#.....OOO...O#..O..O#O.......OO.OO.O.O..O.O....#
#..O.O.O.....O.#....#..O.O..OO..OO.#OO#..OO#...#O#
#.O##O..O......O.......O..#O...O..O.O.OO..O......#
#.#..#.........O.#O...OOO....O.#O....O.....O#O.OO#
#O.OO..#....#........O...OO.......O...#O.......O.#
#......#...#.#.O...........#.OO.O......#.O.OO#...#
#.O#...O......O.O..O.........O...#.O.O...........#
#..O...O#.O..O..O......O.##.OOOOOOO.#O........O..#
#...O..O....O.O.#..O.O#...#O...#OOOO...O#.O.....O#
#.....#.OOO.........O.OO.O#.O#O...OO.........O...#
#.O...#OO.O......OO..........O....OO.#..O....O..##
#.OO#..#.#O......O.O........#O..O.O....O..O.OO.#O#
##################################################
